111111111111
100000000011
1000C011CC11
10P00C101111
10000010C011
101110111011
10CEC00C0011
111111111111