1111111111
1P1C011CC1
1010C10111
1000010C01
1111011101
10E001C001
1111111111
