11111111111
10000000001
10P1C011CC1
10010C10111
10000010C01
10111011101
10CEC00C001
11111111111
