1111111111111111111111
1000000000100000000001
1000C011CC100000000001
10P00C1011100000000001
10000010C0100000000001
1011101110100000000001
10CEC00C00100000000001
1111111111111111111111
